Titre : "map11"
WWWWWWWW.
W......WW
W.S.W.T.W
W.B.BTB.W
WWTWBWBWW
W..T.T..W
W..BW.T.W
WW.....WW
.WWWWWWW.
