Titre : "Test"
WWWWWWWWWWWW
WSW..W.....W
W..W.WBWBW.W
W.BBD......W
WTTWWBWB...W
WTTWT.W..BKW
WTTTTW.B.BWW
W..........W
WWWWWWWWWWWW
