Titre : "Facile"
....WTW....
...D.......
...K.B.....
W....B.....
T.BB.S.BB.T
W....B.....
.....B.....
...........
....WTW....
