Titre : "Map 7"
WWWWWWWWWW
WWK...WWWW
WTD.B.D..W
W.T..S.B.W
W.T....B.W
WTD.B.D..W
WW....WWWW
WWWWWWWWWW
